WZWZWZWZWZWZWZWZWZWZWZWZWZWZWZWZWZWZWZWZWZWZWZWZWZWZWZWZWZWZWZWZWZWZWZWZWZWZWZ
Z0000000000000000000000000000000000000000000000000000000000000000000000000000W
W0000000000000000000000000000000000000000000000000000000000000000000000000000Z
Z0000000000000000000000000000000000000000000000000000000000000000000000000000W
W0000000000000000000000000000000000000000000000000000000000000000000000000000Z
Z0000000000000000000000000000000000011111100000000000000000000000000000000000W
W0000000000000000000000000000000000000000000000000000000000000000000000000000Z
Z0000000000000000000000000000000000000000000000000000000000000000000000000000W
W0000000000000000000000000000000000000000000000000000000000000000000000000000Z
Z0000000000000000000000000000000000000000000000000000000000000000000000000000W
W0000000000000000000WWWWWWWWWWWWWZ0000000000ZWWWWWWWWWWWWW0000000000000000000Z
Z0000000000000000000W000000000000000000000000000000000000W0000000000000000000W
W0000000000000000000W000000000000000000000000000000000000W0000000000000000000Z
Z0000000000000000000W000000000000000000000000000000000000W0000000000000000000W
W0000000000000000000W000000000000000000000000000000000000W0000000000000000000Z
Z0000000000000000000W000000000000000000000000000000000000W0000000000000000000W
W0000000000000000000Z000000000000000000000000000000000000Z0000000000000000000Z
Z0000000000000000000000000000000000000000000000000000000000000000000000000000W
W0000000000000000000000000000000000000000000000000000000000000000000000000000Z
Z0000000000000000000000000000000000000000000000000000000000000000000000000000W
W0000000000000000000000000000000000000ZZ0000000000000000000000000000000000000Z
Z000000000000000000000000000000000000ZWWZ000000000000000000000000000000000000W
W000000000000000000000000000000000000ZWWZ000000000000000000000000000000000000Z
Z0000000000000000000000000000000000000ZZ0000000000000000000000000000000000000W
W0000000000000000000000000000000000000000000000000000000000000000000000000000Z
Z0000000000000000000000000000000000000000000000000000000000000000000000000000W
W0000000000000000000000000000000000000000000000000000000000000000000000000000Z
Z0000000000000000000Z000000000000000000000000000000000000Z0000000000000000000W
W0000000000000000000W000000000000000000000000000000000000W0000000000000000000Z
Z0000000000000000000W000000000000000000000000000000000000W0000000000000000000W
W0000000000000000000W000000000000000000000000000000000000W0000000000000000000Z
Z0000000000000000000W000000000000000000000000000000000000W0000000000000000000W
W0000000000000000000W000000000000000000000000000000000000W0000000000000000000Z
Z0000000000000000000WWWWWWWWWWWWWZ0000000000ZWWWWWWWWWWWWW0000000000000000000W
W0000000000000000000000000000000000000000000000000000000000000000000000000000Z
Z0000000000000000000000000000000000000000000000000000000000000000000000000000W
W0000000000000000000000000000000000000000000000000000000000000000000000000000Z
Z0000000000000000000000000000000000000000000000000000000000000000000000000000W
W0000000000000000000000000000000000022222200000000000000000000000000000000000Z
Z0000000000000000000000000000000000000000000000000000000000000000000000000000W
W0000000000000000000000000000000000000000000000000000000000000000000000000000Z
Z0000000000000000000000000000000000000000000000000000000000000000000000000000W
W0000000000000000000000000000000000000000000000000000000000000000000000000000Z
ZWZWZWZWZWZWZWZWZWZWZWZWZWZWZWZWZWZWZWZWZWZWZWZWZWZWZWZWZWZWZWZWZWZWZWZWZWZWZW